last_name
Elsworth	Sandcraft
Elmer	Ducaen
Kacey	Giraudo
Darci	Fenning
Leonanie	Priestnall
Holli	Jenney
Maible	Borzoni
Morena	Lackie
Zarah	Mallord
Eduino	Housegoe
Berri	Larose
Roddie	Walding
Leoline	MacLise
Cesare	Olliff
Nickie	Trevethan
Jeannie	Wegener
Gib	Allan
Mikkel	Hebbs
Claudette	Deschelle
Albina	Bannell
Lauretta	Novis
Blane	Panchen
Jo	Maffiotti
Derk	Lesser
Jessie	Lyburn
Janice	Killough
Ollie	Maryott
Malvina	Rebillard
Ruthy	Tuckwood
Fianna	Gabits
Kessiah	Lapre
Margot	McPhillimey
Gui	Cicculini
Evvie	Langman
Roderic	Griswaite
Staford	Esseby
Meghan	St Ledger
Latia	McIlwraith
Tedi	Corah
Ramona	Harley
Abba	Slegg
Christabel	Fardy
Kory	Church
Lilllie	Fortnam
Fanchette	Witherden
Agatha	Woodworth
Maudie	Ottewell
Cobby	Lowrey
Ara	Gristwood
Kaye	Well
Nicolais	Dickinson
Hank	Medlar
Collen	Proger
Trude	Giotto
Cosme	Huffey
Annabela	Teggart
Garner	Fruchon
Bengt	Swarbrigg
Maurice	Althrope
Eveleen	Hinz
Kelcey	Cristoforo
Randell	Aleavy
Nevins	Yakuntzov
Roscoe	Kersey
Wilow	Sabin
Far	Grier
Del	Busby
Orbadiah	Alti
Delilah	Andriss
Lanna	Hawksley
Ainslie	Magrane
Stacie	Daskiewicz
Claiborne	Scain
Ginni	Markovich
Valentine	Mockett
Barnabe	Canet
Gustav	Husband
Zorine	Mozzini
Mechelle	Ingerfield
Monica	MacDonell
Giffie	Rispin
Brady	Hovenden
Bram	Rodger
Lian	Rabley
Annadiana	McCalum
Kaela	Kitchingman
Ignaz	Fathers
Rocky	Stoll
Ferne	de Nore
Alina	Menere
Nikola	Lamperd
Amalle	Mazdon
Bettye	Mottini
Austin	Well
Cammie	Curbishley
Gerhard	Saing
Lonnie	Frogley
Josiah	Annear
Gabie	De Mars
Freddie	Bahia
Emmery	Bumphrey
Homer	Dobrovsky
Fonz	Sommerlie
Maggy	Leeuwerink
Vonni	Proughten
Daron	Janusz
Tamqrah	Samudio
Gard	Longforth
Arney	Albrecht
Trenton	Buse
Ingamar	Pardue
Matty	Haslum
Lorita	Sedgmond
Elyse	Adam
Amalie	Lummus
Helaine	Setter
Cobby	Delgaty
Cassey	Cleaver
Corie	Blitzer
Susie	Packer
Natale	Petchell
Stephani	Lachaize
Fayth	Simionescu
Cornelia	Cucinotta
Katalin	McGiffie
Davide	Godleman
Hermia	Le Prevost
Billie	Labro
Helene	Sanbrooke
Valeria	Hungerford
Arel	Hardi
Mayor	Lerven
Eadie	Jewitt
Hattie	Scard
Jaynell	Van Arsdall
Aluino	Debill
Graig	Van Arsdall
Pennie	Tash
Concettina	Jenman
Reba	Gregine
Rochelle	Sebborn
Celeste	Dumigan
Noell	De la Yglesias
Moina	Critchley
Cecil	Ebbers
Linus	Swaffer
Gabriele	Gwioneth
Gwendolyn	Reddle
Ferguson	St Louis
Tommy	Roussell
Robbert	Daoust
Loretta	Imison
Anabal	Siemens
Lorna	Micheli
Giana	Kennsley
Regina	Backshall
Claudetta	Whale
Scarlet	Pierton
Valentino	Hurlston
Ban	Pointing
Rosabella	Stonuary
Pebrook	Lally
Milty	Rolley
Mattheus	Leband
Berky	Yeardley
Rani	Drake
Tiff	Saurat
Jodi	Antos
Cchaddie	Queripel
Shaylyn	Dutnell
Nalani	Assiter
Geoffrey	Escoffier
Roz	Gallaccio
Sofie	Itscowicz
Christabella	Wadham
Dian	Sperski
Lonee	Jeness
Giorgi	Vanns
Adriaens	Peasby
Melvin	Moulin
Kara	Raccio
Monty	Haslock
Chickie	Hollier
Stefania	Happert
Godiva	Skea
Byrann	Trebble
Andra	Hatton
Pat	Seedman
Debbi	Laurant
Uta	Cabble
Laverna	Ead
Mateo	Kilmary
Mellisent	Saylor
Pooh	Cage
Cathrin	Renzo
Jay	Tribell
Val	Benditt
Friedrich	Kleewein
Donnie	Faull
Tarrance	Caldera
Danna	Pearsall
Frants	Crosfield
Kylila	Yeend
Sianna	Escoffrey
Cary	Huntingdon
Nissa	Westell
Brander	Kleinplac
Rosalind	Drewitt
Damon	Lamonby
Reina	Ferrino
Jacquenetta	de Pinna
Charo	Hevner
Bo	Gillanders
Joelynn	de Vaen
Abbey	Boatright
Antin	Lamort
Eward	Snel
Rabbi	Sheard
Skelly	Wase
Richard	Rouf
Ellene	Pember
Darrin	Cosgrove
Hinze	Antonioni
Winfield	Shore
Karlotta	Wennington
Siffre	Raven
Genna	Beare
Grace	Liver
Chick	Duprey
Ralph	Fennessy
Haley	Kohter
Vincenz	Beere
Lefty	Scamaden
Ayn	Ionnidis
Bret	Abramovic
Witty	Keller
Fitzgerald	Ainsworth
Maridel	Headrick
Denny	Gostling
Tish	Livesley
Eduino	Bellison
Bordie	Heinl
Glad	Hewins
Iver	Ferraraccio
Janeczka	Simak
Celle	Midgely
Lurlene	Scripps
Zsa zsa	Trubshawe
Karyn	Duckhouse
Agosto	Kale
Milton	Davidoff
Toinette	Hafford
Hermann	Bartod
Genovera	Scarffe
Rodolfo	Western
Adela	Rojas
Alphonso	Ravenscroftt
Alanson	Noyce
Noelani	Draijer
Midge	Smaile
Benedicta	Treadwell
Kora	Felton
Aigneis	Plaistowe
Janot	Layus
Vernen	Stenett
Hyacintha	Dockrill
Patricia	Killik
Lynett	Gittens
Allx	Kensy
Waldon	Soonhouse
Milt	Thirst
Francesco	Craigg
Dimitri	Scallon
Erena	Heijne
Emmy	Valek
Towney	Dowle
Delbert	Winton
Del	Noweak
Carmita	Guilbert
Ruby	Compford
Raymond	Nozzolinii
Nellie	Alvarez
Clayborne	Wakeling
Kitti	Blazewski
Nicki	O'Lyhane
Hurlee	Redmond
El	Slyford
Anabel	MacNeilage
Laure	Dries
Davon	Vegas
Munroe	Huffy
Sheelah	MacCrackan
Annecorinne	Dumke
Petronille	McCoughan
Devlen	Mundee
Kyle	Lapides
Cordy	Adamthwaite
Tisha	Etter
Shane	Guisot
Yorke	Goldthorp
Clemente	Sergeant
Phil	Tombleson
Gretal	Vedstra
Merrielle	Burgh
Daloris	Worshall
Blinny	Brimilcombe
Aubree	Attewill
Kris	Goudy
Alaine	McGriele
Baird	Tremolieres
Cleo	Wyllcock
Tymothy	Tolworthie
Mendie	Ellings
Amabelle	Cappel
Dame	Senten
Earlie	Trevorrow
Shanan	Bollum
Tine	Adey
Dallis	Loynes
Renard	Skoughman
Dov	Blissitt
Nissy	Tween
Humphrey	Veronique
Jamil	Lafford
Sabrina	Falkous
Lacey	Pyburn
Derk	Gallyhaock
Orly	Wallentin
Wolfie	Halshaw
Juliane	Watford
Deena	Benoist
Carrol	Duffett
Amery	Sich
Ricca	Tommasetti
Myranda	Tyres
Cordy	Bothie
Chester	Jarvie
Giorgio	Boland
Desirae	Churches
Moe	Sugge
Arron	Mordecai
Brooks	Ceschi
Conrado	Meltetal
Alexandro	Dungate
Micah	Medeway
Starla	Nezey
Theodore	Leward
Pooh	Bobasch
Farica	Scarffe
Bambi	Blasik
Zollie	Rasmus
Emily	Stradling
Humfrid	Lusk
Tiffy	Ternent
Lira	Matthieson
Fraser	Highton
Ammamaria	Ruseworth
Mae	Nanninini
Nicolai	Downton
Reid	Burchell
Salome	Munday
Janos	Robertazzi
Reginauld	Brome
Adi	Paradyce
Nowell	Davidowsky
Maggy	Gonnard
Freddi	Jephcote
Cherice	Como
Mufi	Blade
Luisa	Dabnot
Peterus	Massie
Shanda	Billany
Wittie	Insley
Dewain	Dyball
Jessi	Dake
Pepillo	Sellack
Christoforo	Bayman
Jehu	Focke
Giorgio	Playle
Rodrigo	Brandham
Gabriell	Lowmass
Delilah	Compford
Rheta	Moodie
Amity	Lowles
Babs	Mussett
Elston	Ungerechts
Ebonee	Bremeyer
Corey	Chastan
Latisha	Willoughey
Bellanca	Allcorn
Colene	Braidwood
Jae	Stennard
Codie	Brumham
Fredek	Wheeliker
Early	Eyles
Haskel	Whiscard
Audrie	Stuther
Claudie	Bewshea
Julieta	Dyett
Gretna	Lafaye
Ervin	Levinge
Abey	McSporrin
Dulci	Connick
Jenny	Riveles
Neddy	Seamons
Bria	Boullin
Normie	Brettle
Betsey	Macer
Emera	Beany
Byrann	Baty
Jyoti	Lewin
Xerxes	Gotcliffe
Melodee	Woodward
Kirk	Rosbotham
Sharline	Caddies
Carma	Dulson
Emmery	Milkin
Janek	Duckerin
Lillian	Robjant
Melonie	Kyme
Brew	Peartree
Camella	Mitrovic
Melinda	Truin
Felipe	Koppeck
Zita	Teaz
Cathee	Bourcq
Rasla	McIllrick
Cort	Van Hault
Hadleigh	Farre
Harrison	Trineman
Rustin	Casassa
Alika	Wiffield
Enoch	Stilldale
Yehudi	Blackeby
May	Samuels
Perceval	Hamstead
Odette	McVane
Nady	De Anesy
Colan	Stockle
Nanon	MacCallum
Georgetta	Gilleson
Cyrillus	Rhyme
Carlo	Debrett
Ame	Udey
Fields	Hessenthaler
Millisent	Woods
Heindrick	Heinert
Jessamine	Flores
Bondie	Curzon
Diena	Aldam
Vinnie	Guilloud
Quintana	Gurg
Andeee	Bangle
Duke	Steers
Gray	Gartery
Clarey	Blankau
Elvyn	Laverack
Nonah	Mantz
Alane	Cooksey
Matty	Poynter
Cindra	Cozens
Elbert	Biskupski
Leonid	Dady
Dale	McSporrin
Quincey	Olyfant
Cathe	Rooper
Delcina	Snape
Pierson	Sainteau
Tom	Tinto
Ryon	Dachey
Cassey	O'Reilly
Damian	Dorkins
Romola	Quilter
Reinold	Grendon
Nancy	Geal
Christoffer	Girvan
Harwell	Turgoose
Gustave	Stormonth
Jasmina	Dunaway
Audrey	Eddie
Cassandre	Thurlborn
Nikolos	Joburn
Jewelle	Reyna
Giavani	Jeavons
Arel	Darbishire
Geri	Barrack
Juditha	Geffe
Phyllys	Slograve
Hendrick	Coveny
Lauren	O'Hederscoll
Madelena	Kleuer
Penrod	Vannuccinii
Van	Naisbit
Erasmus	Hugk
Berna	Younger
Cleo	Potte
Jo	Domleo
Dalton	MacInerney
Mel	Ayris
Karisa	Poveleye
Davin	Kitt
Micheline	Beharrell
Tandie	Tonbye
Kerby	Devil
Ayn	Mecozzi
Francesca	Bernot
Carine	Fazackerley
Jacquelin	Noteyoung
Thomasin	Astbery
Ches	Mustin
Dean	Winyard
Elena	Spaight
Chicky	Ayshford
Mitchell	Garlett
Nikoletta	Frossell
Edi	Mugford
Gunner	Jinkin
Stevana	Gilhoolie
Dermot	Tripe
Harmon	Falshaw
Bertine	Petchey
Angelique	Gateland
Tommy	Gierardi
Augusta	Varnals
Aeriell	Bugge
Carmelia	Bartlet
Harland	Gartenfeld
Leena	Bartunek
Binky	Pencost
Meris	Oakwood
Jeniffer	Mobley
Jaquenetta	Cahani
Linea	Code
Isac	Edsall
Amye	Bines
Urban	Marriott
Izaak	Yarmouth
Titos	Haighton
Sarena	Caddie
Winnifred	Doctor
Bill	Iston
Claudine	Fermoy
Marlo	Sikorsky
Kevan	Barreau
Gasparo	Collister
Lyndsey	Gracey
Analiese	Rannie
Carly	Iashvili
Rene	Crother
Piper	Barth
Bank	Slarke
Valeria	Culleton
Rosette	De Carolis
Cleve	Blackden
Benji	Brammall
Welsh	McGregor
Othelia	Greenlies
Thaine	Donne
Ann	Cristofor
Kaspar	Sharper
Kip	Jollie
Filide	Gossage
Godfrey	Hullock
Lev	Duding
Leann	Millichip
Meggie	Middlehurst
Elise	McLukie
Gillan	Purdey
Shannon	Dunckley
Aggie	Mennear
Kayla	Pulbrook
Tobey	Tawton
Torry	Dengel
Son	Moizer
Amber	Wordsworth
Claresta	Edmondson
Fritz	Grzesiewicz
Dela	Maypother
Stephani	Dalley
Ira	Bridgwater
Zechariah	Mityashev
Devlen	Sorey
Pepillo	Abriani
Wilma	De Miranda
Tyrus	Cobb
Hy	Halahan
Marwin	Orrey
Hildy	Crosthwaite
Jeniece	Aurelius
Madalyn	Baraja
Averell	Potzold
Rand	Hunnable
Timmy	Edwick
Shelby	Darwent
Nona	Gile
Jacob	Barnbrook
Liam	Itscovitz
Kirbee	Schuricke
Sal	Coetzee
Sonja	Graybeal
Peyton	MacCrossan
Harlen	Pollicote
Shannen	Morilla
Boony	Meighan
Dennie	Demelt
Erin	Boom
Hailey	Stodit
Osmond	McKeurtan
Fabiano	Meyrick
Joyous	Miner
Gnni	Bourrel
Damiano	Sparke
Ody	Bentinck
Deena	Vanini
Jolie	Crayton
Renato	Lavigne
Cyndie	Bohman
Evangeline	Scripture
Arne	Rama
Nathaniel	Rennles
Nolana	Brangan
Tracie	Cyphus
Susanetta	Beedon
Jocelyne	Sizland
Carin	Botterman
Reinaldos	Hendriksen
Vinson	MacConchie
Jewel	Goodsir
Lorry	Drinkhill
Kiersten	Jencey
Erskine	Treeby
Lettie	Eaglen
Rozele	Gerbi
Verene	Leban
Papageno	Girodias
Tyler	Spoure
Ruthanne	D'Cruze
Dorthea	Dachey
Annalee	Rickets
Stormi	Landreth
Bronnie	Buckley
Dollie	Humphrey
Staffard	Cowill
Mattie	Linden
Noelani	Albion
Malachi	Carriage
Glenn	Durkin
Dehlia	Cave
Jerrilee	Lacroutz
Stillman	Oboy
Gelya	Johnston
Allyson	Durn
Winna	Ardley
Allan	Deacon
Dermot	Peakman
Honoria	Dewdney
Linnet	Cattemull
Jackelyn	Dormer
Lazar	Rodson
Frank	Embleton
Amara	Gaiter
Dacey	Bisiker
Rosana	Verrell
Chrisy	Geikie
Jackie	Goacher
Sonnie	Harsum
Karoly	Whitington
Willy	Rasmus
Wallace	Clackson
Nathalie	Walework
Dun	Ferraretto
Marci	Durram
Alphard	Ballendine
Felic	Zoellner
Bernadina	McNay
Bethany	McIlmurray
Yetty	Sappell
Grange	Poynzer
Hadlee	Queen
Loralee	MacVagh
Inglis	Gerardin
Muriel	Vize
Valene	Plant
Layla	Ferrey
Lizabeth	Awcock
Tessi	Coleson
Garrard	MacGeaney
Gonzalo	Roberto
Wilow	Theakston
Dagmar	MacInherney
Tallia	Stanning
Skyler	Pattenden
Philbert	Lennie
Eydie	Fairlem
Kean	Thomasson
Scottie	Norres
Manfred	Marty
Loree	Farfalameev
Rafe	Bridgett
Bent	Bolden
William	Danihelka
Aurore	Aland
Jamison	Burker
Correy	Gorst
Stephanus	Saterweyte
Rice	Greenall
Jordon	Abbado
Theda	De Beauchemp
Tiphanie	Mathie
Vittorio	Kenaway
Bran	Bails
Ancell	Keuntje
Laure	Chorley
Mariejeanne	McFayden
Cornelle	Elrick
Joeann	Rosenbarg
Matteo	Hagard
Nonie	Sazio
Ainsley	Edrich
Aurel	Aylett
Claribel	Baily
Liva	Suermeier
Shanie	Woodrough
Bobbi	Paolucci
Bianca	Gipps
Friederike	Lyptrade
Debbi	Godleman
Natalee	Minster
Wildon	Siuda
Selma	Arnaud
Gan	Ferreres
Virgil	Rubrow
Maurice	Redhead
Lacie	Losemann
Barbee	Webland
Tommie	Aspinall
Gilligan	Gregoratti
Nani	Lamplugh
Trumann	Huskinson
Susan	Overington
Zorana	Adkin
Edan	Poulden
Jandy	Silliman
Cory	Oleshunin
Janis	Redmille
Clarice	Quiddihy
Shadow	Wichard
Dyanna	Sigward
Joann	Foat
Allsun	Riccardelli
Mohammed	Gutans
Julianne	Langmead
Trumaine	Oswal
Sterling	Vigars
Henri	Clausen
Reese	Gurrado
Adrienne	Buttfield
Tove	Bridell
Timmy	Le Brun
Rena	Androck
Nita	Korejs
Kissie	Armer
Winnie	Buyers
Othelia	Thorley
Thain	Pyrah
Mabel	Aspital
Case	Gartan
Maible	Dorin
Nickolas	Tarney
Bartlet	Pretley
Adena	Ricciardiello
Dalenna	Muckersie
Erminie	Bankhurst
Skipton	Paulin
Christos	Windmill
Kelsey	Jaram
Merrill	Bortolozzi
Greer	Ghirigori
Ulla	Fenge
Dene	Gregori
Kipp	Dady
Moyna	Baverstock
Talbot	Cardwell
Barbra	Ledur
Christen	Biasotti
Shae	Kirrens
Heida	Asman
Gallagher	Locard
Kennett	Whistance
Codi	Forseith
Hirsch	Carlton
Ragnar	Santarelli
Venita	Yate
Florry	Stockill
Ulrick	Cressor
Barty	Brayley
Blanche	Vyvyan
Ara	Pettigree
Ritchie	Bellwood
Addi	Threlfall
Nessy	Rhucroft
Daffi	Haistwell
Ferris	Janicijevic
Correna	Lorenzin
Whitman	Hazeldean
Elmo	Crebo
Patten	Eastabrook
Ulysses	Sherry
Bucky	Gavin
Benedicto	Leverich
Jeddy	Buske
Brewer	Beet
Allina	Maw
Ewart	Gainor
Hakeem	Blackater
Stephen	Morgan
Gusti	Defries
Jacinthe	Khristoforov
Kathe	Barnewelle
Shina	Wheowall
Chauncey	Archbold
Lelia	Fletcher
Rakel	McLukie
Sosanna	Schleicher
Joann	Jenkyn
Francisco	Sleeford
Waneta	Tinker
Valentia	Stonehouse
Keen	Tolossi
Emmet	Durban
Burlie	Dallicoat
Reba	Martinetto
Dorothea	Halgarth
Mortimer	Bulpitt
Odey	Barneveld
Inesita	Wigginton
Clim	Usborn
Boycie	Lockney
Loria	Broggetti
Yorke	Dunwoody
Toby	Clibbery
Kip	Cowsby
Dickie	Gooding
Rog	German
Polly	Gorse
Cal	Hicken
Emily	Denerley
Christy	Pardi
Camila	Dullingham
Tessy	Yapp
Angel	Darby
Grazia	Ballin
Tiphanie	Dilworth
Alejandrina	Salleir
Germayne	Brunel
Blisse	Yepiskopov
Walden	Cherrett
Liza	O'Tuohy
Babs	Toffts
Dick	Playden
Charity	Bagby
Sidonnie	Linnell
Rosaline	Stannett
Weber	Pickervance
Roanna	Clemenzi
Dalila	Guerreau
Rowney	Pendrich
Baillie	Pentin
Darnell	Gainsburgh
Burnaby	Finding
Craig	Perrigo
Terese	Aingel
Ruperto	De La Haye
Charmine	Mulqueeny
Carolin	Darkin
Isiahi	MacTerrelly
Isadora	Peverell
Nata	Sygroves
Koo	Priestman
Kim	Partrick
Erny	Knowler
Shermie	Scorey
Suzette	Robjents
Yule	Flew
Gipsy	Challoner
Natalya	Brumby
Melitta	Smead
Herold	Piesold
Hope	Goundrill
Marsha	Kynston
Yancy	Loeber
Anastasia	Hubbock
Ruthe	Critchlow
Lurette	Aberdein
Remus	Parren
Christean	Risborough
Elinor	Rooke
Ruthanne	Bordes
Bibbie	Goodfield
Torey	Preist
Cole	Pidgeley
Anita	Shand
Connie	Labbey
Brig	Siddens
Todd	Linke
Rea	Stathers
Christen	Delgardo
Darcy	Featherbie
Kristoffer	Seery
Halimeda	Berrigan
Rickie	Clendennen
Aland	Hoyle
Birgitta	Deas
Nathaniel	Divina
Demetria	Howsam
Nicole	Kenan
Cesar	De Moreno
Karia	Philipeaux
Holly-anne	Handrek
Casandra	Woolens
Fabian	Baroux
Steffie	Di Maria
Wyatt	Itshak
Quill	Blown
Bryce	Duchart
Hilary	Allicock
Langsdon	Cornils
Fonz	Hugueville
Base	Standeven
Peyter	Berrygun
Allianora	Roberts
Aila	McTeague
Novelia	Iorizzo
Caesar	Bollans
Farica	Olenichev
Mason	Charley
Kathlin	Trembath
Aurelie	Scolding
Chandler	Zettoi
Eran	Hewes
Reeta	Crome
Lonny	Klimochkin
Abey	Lambertini
Denney	Brauner
Heather	Treanor
Iona	Lumsdale
Shayne	Bonnyson
Tiff	Daouse
Lesli	Lafflina
Consolata	Gore
Fae	Surby
Kearney	Petican
Borden	Ludwig
Jeramie	Style
Sophi	Burnhard
Ofilia	Rainard
Veronique	Lintin
Sadye	Collins
Almeria	Sibly
Gwenni	Marlow
Bo	Pashe
Gloriane	Turnock
Egor	Dohmer
Jerald	Twigger
Son	Andreev
Ebony	Willingham
Bendite	Seven
Anita	Drinan
Ronica	Waber
Inness	Geertz
Hagan	Labet
Konstantine	Marnane
Cameron	Hoyes
Matt	De Hailes
Forrester	Dake
Gregoor	L'Archer
Fin	Corneljes
Carlin	Miklem
Sher	Godain
Hilary	Parnall
Dagny	Fortesquieu
Jonie	Szach
Caro	Dwight
Clevey	Greensted
Brandyn	Keeffe
Elbert	Lucien
Celeste	Titheridge
Chelsea	Duckham
Marguerite	Antonsson
Kearney	Kitchener
Maurizia	Jephson
Jenny	Dewen
Ainsley	Espinho
Amandi	Caslake
Aggy	Fuller
Jamill	Lyston
Coreen	Ryson
Ailene	Matuschek
Umberto	Cordero
Derril	Hawsby
